   ########################
   #..........##...........
   #.##.## ##.##.##.##.##.#
####.##.## ##.##.##.##.##.#
#O...##.##....  ....##.##.#
#.#####.##.###########.##.#
#.#####.##.###########.##.#
#.......##.##.............#
#######.##.##.########### #
#######.##.##.########### #
#....##.##..........##     
#.##.##.#####.##.##.## ####
#.##.##.#####.##.##.## #   
#.##.........O##.##.   #   
#.###########.##.##.## #   
#.###########.##.##.## ####
#..........##.##....##     
#.########.##.########### #
#.########.##.########### #
#.......##.##..........## #
#######.##.##.########.## #
#######.##.##.########.## #
#.............  ....##.... 
#.##.##.##.##.##.##.## ##.#
#.##.##.##.##.##.##.## ##.#
#.##.##.##.##.##.##.## ##.#
#.##.##.##.##.##.##.## ##.#
#.##.##.##.##.##.##.## ##.#
#O............##..........#
###########################