   ########################
   #.......................
   #.########.##.#####.####
####.########.##.#####.####
#..........##.##..........#
#.########.##.###########.#
#O########.##.###########.#
#.......##.  .............#
#.#####.##.##.########.####
#.#####.##.##.########.####
#....##.##.##.......##.    
#.##.##.##.##.##.##.##.####
#.##.##.##.##.##.##.##.#   
#.##....  ....##O##.##.#   
#.#####.#####.##.##.##.#   
#.#####.#####.##.##.##.####
#....##....##.##.##....    
#.##.#####.##.##.######## #
#.##.#####.##.##.######## #
#.##....##....##.......   #
#.## ##.#####.##.#####.####
#.## ##.#####.##.#####.####
#....##.......  .#####.... 
####.##.#####.##.#####.##.#
####.##.#####.##.#####.##.#
#....##.##....##.......##.#
#O#####.##.##.##### #####.#
#.#####.##.##.##### #####.#
#..........##..............
###########################