###########################
#.............##..........#
#.##.#####.##.##.## #####.#
#.##.#####.##.##.## #####.#
#O##.......##....##....##.#
#.##.#####.##.#####.##.##.#
#.##.#####.##.#####.##.##.#
#.  .......##.##....##.....
#.##.#####.##.##.##### ####
#.##.#####.##.##.##### ####
#.##....##.  .......       
#.##.##.##.##.#####.## ####
#.##.##.##.##.#####.## #   
#....##....##...O...## #   
#.########.##.#####.## #   
#.########.##.#####.## ####
#.  .......##.......       
#.##.#####.##.## ##### ####
#.##.#####.##.## ##### ####
#.##....##.##.##   .......#
#.#####.##.##.#####.#####.#
#.#####.##.##.#####.#####.#
#......................... 
#.##.##### #####.##.## ####
#.##.##### #####.##.## ####
#O##.##.......  .##.##....#
#.##.##.#####.##.##.##.##.#
#.##.##.#####.##.##.##.##.#
#.............##.......##..
###########################