###########################
#....##.......##..........#
#.##.##.##.##.##.##.##.##.#
#.##.##.##.##.##.##.##.##.#
#.##....##.##....##.##.##..
#.########.########.##.####
#.########.########.##.####
#....##...O...##.......   #
#.##.##.##.##.##.##.##### #
#.##.##.##.##.##.##.##### #
#.##....##.##....##.##     
#.########.########.## ####
#.########.########.## #   
#....##.......##....   #   
####.##.#####.##.##### #   
####.##.#####.##.##### ####
#.......##....  ....##     
#.##.#####.########.##### #
#.##.#####.########.##### #
#.##....##....  ....##    #
#.##.##.#####.##.##### ####
#.##.##.#####.##.##### ####
#....##O......##.......##  
#.#####.##.########.##.## #
#.#####.##.########.##.## #
#.......##.##....##.##....#
#.#####.##.##.##.##.##.####
#.#####.##.##.##.##.##.####
#.......##....##....##.....
###########################