###########################
#................##.......#
#.#####.##.##.##.##.##.##.#
#.#####.##.##.##.##.##.##.#
#O##....##.##.......##.....
#.##.#####.#####.##### ####
#.##.#####.#####.##### ####
#.......##......O   ##    #
#.#####.#####.##.## ##### #
#.#####.#####.##.## ##### #
#....##.......##.##        
#.##.#####.#####.##### ####
#.##.#####.#####.##### #   
#.##.##.......##....   #   
#.##.##.#####.#####.## #   
#.##.##.#####.#####.## ####
#..........##.......##     
#.##.#####.#####.##### ####
#.##.#####.#####.##### ####
#.##....##.##.......##    #
#.#####.##.##.#####.##### #
#.#####.##.##.#####.##### #
#................##....... 
####.##.##.#####.#####.##.#
####.##.##.#####.#####.##.#
#....##.##....##.##....##..
#O#####.#####.##.##.#####.#
#.#####.#####.##.##.#####.#
#.........................#
###########################