###########################
#..........##....##........
#.#####.##.##.##.##.#####.#
#.#####.##.##.##.##.#####.#
#...O...##....##..........#
#.##.##.##.#####.##### ##.#
#.##.##.##.#####.##### ##.#
#.##.##.  .  .......   ##..
#.##.##.##.##.#####.## ####
#.##.##.##.##.#####.## ####
#....  .##.##.......##     
####.##.##.##.##.##.## ####
####.##.##.##.##.##.## #   
#....##.  .  .##O##.   #   
#.##.##.##.##.##.##.## #   
#.##.##.##.##.##.##.## ####
#.##.  .##.##.......##     
#.##.##.##.##.#####.##### #
#.##.##.##.##.#####.##### #
#....##....  .......      #
####.##.##.##### ##### ####
####.##.##.##### ##### ####
#.......##.............    
#.#####.##.##.#####.##.####
#.#####.##.##.#####.##.####
#.##......O##.  ....##....#
#.##.#####.##.##.########.#
#.##.#####.##.##.########.#
#.............##...........
###########################