###########################
#..........##....##....##..
#.########.##.##.##.##.##.#
#.########.##.##.##.##.##.#
#.##....##.##.##.  .##....#
#.##.##.##.##.##.##.#####.#
#.##.##.##.##.##.##.#####.#
#.##...O...##....##.......#
#.#####.##.##.#####.##### #
#.#####.##.##.#####.##### #
#................##.##     
##########.##.##.##.## ####
##########.##.##.##.## #   
#.......##.##.......   #   
#.#####.##.##.######## #   
#.#####.##.##.######## ####
#..........##.......       
##########.##.##.##.##### #
##########.##.##.##.##### #
#................##.##    #
#.#####.##.##.#####.## ####
#.#####.##.##.#####.## ####
#.##...O...##....##.##.... 
#.##.##.##.##.##.##.#####.#
#.##.##.##.##.##.##.#####.#
#.##....##.##.##.  .......#
#.########.##.##.##.#######
#.########.##.##.##.#######
#..........##....##........
###########################