


  ##############
  #............#
  #.####.#####.#
  #O####.#####.#
  #.####.#####.#
  #.............
  #.####.##.####
  #.####.##.####
  #......##....#
  ######.##### #
       #.##### #
       #.##   w 
       #.## ####
########.## #   
<<<<<<<<.   #   
########.## #   
       #.## ####
       #.##     
       #.## ####
  ######.## ####
  #............#
  #.####.#####.#
  #.####.#####.#
  #O..##......W 
  ###.##.##.####
  ###.##.##.####
  #......##....#
  #.##########.#
  #.##########.#
  #.............
  ##############