


  ##############
  #.............
  #.##.####.####
  #O##.####.####
  #.##.####.##..
  #.##......##.#
  #.####.##.##.#
  #.####.##.##.#
  #......##....#
  ###.######## #
    #.######## #
    #....##     
##### ##.## ####
<<<<< ##.## #   
########.   #   
########.## #   
<<<<< ##.## ####
##### ##.##     
    #....##### #
    #.##.##### #
    #.##....   #
    #.#####.## #
  ###.#####.## #
  #.........##  
  #.####.##.####
  #.####.##.####
  #.##...##.....
  #O##.#######.#
  #.##.#######.#
  #............#
  ##############

