


  ##############
  #.........##..
  #.#######.##.#
  #O#######.##.#
  #.##.........#
  #.##.##.####.#
  #....##.####.#
  ####.##.####.#
######.##.......
<<<....#### ####
###.## #### ####
  #.##          
  #.#### ## ####
  #.#### ## #   
  #.     ## #   
  #.## #### #   
  #.## #### ####
  #.##          
  #.#### ##### #
  #.#### ##### #
  #......##....#
  ###.##.##.####
  ###.##.##.####
  #O..##........
  #.####.#####.#
  #.####.#####.#
  #......##....#
  #.####.##.####
  #.####.##.####
  #......##.....
  ##############


