


  ##############
  #......##.....
  #O####.##.####
  #.####.##.####
  #.............
  ###.##.#####.#
    #.##.#####.#
#####.##.#####.#
<<<<<.##.......#
#####.##### ####
    #.##### ####
    #.          
    #.##### ####
    #.##### #   
    #.##    #   
    #.## ## #   
#####.## ## ####
<<<<<.   ##     
#####.######## #
    #.######## #
    #.......   #
    #.#####.####
  ###.#####.####
  #............ 
  #.####.#####.#
  #.####.#####.#
  #.####.##....#
  #O####.##.####
  #.####.##.####
  #.............
  ##############

